ACH = "countries/ACH - Alamo Chapter.txt"
ALA = "countries/ALA - Lanius's Cohort April.txt"
ANO = "countries/ANO - Anointed.txt"
SLA = "countries/SLA - Slags.txt"
ARM = "countries/ARM - Army of Mexico.txt"
ARR = "countries/ARR - Arroyo.txt"
ARZ = "countries/ARZ - Arizona Rangers.txt"
ASF = "countries/ASF - Archdiocese of Santa Fe.txt"
ASS = "countries/ASS - Assassin City Rollergirls.txt"
ATE = "countries/ATE - Aztec Empire.txt"
BAG = "countries/BAG - Baggers.txt"
BAM = "countries/BAM - Bayou Motors.txt"
BCR = "countries/BCR - Tibbets Raiders.txt"
BDT = "countries/BDT - Bone Dancer.txt"
BEL = "countries/BEL - Bellingham.txt"
BJS = "countries/BJS - Baja State.txt"
BLC = "countries/BLC - Black Canyon.txt"
BLK = "countries/BLK - Blackfoot.txt"
BLO = "countries/BLO - Beltran-Leyva.txt"
BLP = "countries/BLP - Paz Bandits.txt"
#BOM = "countries/BOM - Brotherhood of Mars.txt"
BOO = "countries/BOO - Boomers.txt"
BOS = "countries/BOS - Brotherhood.txt" #Lost Hills
BSF = "countries/BSF - San Francisco Chapter.txt"
BLS = "countries/BLS - Lyons' Brotherhood.txt"
BGF = "countries/BGF - Gulf Brotherhood.txt"
BMW = "countries/BMW - Midwest Brotherhood.txt"
BAP = "countries/BAP - Appalachian Expedition.txt"
BRI = "countries/BRI - Brigham Barons.txt"
BRK = "countries/BRK - Broken Coast.txt"
BRT = "countries/BRT - Broken Hearts.txt"
BSU = "countries/BSU - Black Sun.txt"
BVC = "countries/BVC - Valle Bandits.txt"
CAF = "countries/CAF - Costa Cafeinada.txt"
CAR = "countries/CAR - The Carthaginians.txt"
CBN = "countries/CBN - Carbon.txt"
CCW = "countries/CCW - Carcass Walkers.txt"
CES = "countries/CES - Caesar's Legion.txt"
CHC = "countries/CHC - Chained Choir.txt"
CHE = "countries/CHE - Chemult Station.txt"
CHO = "countries/CHO - Choctaw.txt"
CHR = "countries/CHR - Cheroke.txt"
CIP = "countries/CIP - Ciphers.txt"
CLJ = "countries/CLJ - ClaimJumpers.txt"
CLK = "countries/CLK - Timekeepers.txt"
CMC = "countries/CMC - Chickasaw-Muscogee Coalition.txt"
COL = "countries/COL - Colorado State.txt"
COW = "countries/COW - Cowboy Country.txt"
CRA = "countries/CRA - The Commander's Arsenal.txt"
CRZ = "countries/CRZ - Crazy Horns.txt"
CWB = "countries/CWB - Cypher Warband.txt"
CYC = "countries/CYC - Badland Buckaroos.txt"
DAM = "countries/DAM - Dam Busters.txt"
DEA = "countries/DEA - Dead Horses.txt"
DES = "countries/DES - Desert Rangers.txt"
DIS = "countries/DIS - The Disciples.txt"
DRE = "countries/DRE - Dredgers.txt"
DRY = "countries/DRY - Dryblowers.txt"
DSL = "countries/DSL - Duoshou Lu.txt"
DSP = "countries/DSP - Desperados.txt"
EAS = "countries/EAS - Eastport.txt"
EAG = "countries/EAG - Eagle Rock.txt"
ECU = "countries/ECU - Eclipse Uprising.txt"
EDA = "countries/EDA - Earth Defence Army.txt"
EDN = "countries/EDN - Eden.txt"
EHT = "countries/EHT - Eighties.txt"
EMB = "countries/EMB - Eastern Umbra.txt"
ENC = "countries/ENC - Western Enclave.txt"
EXE = "countries/EXE - The Executives.txt"
FAR = "countries/FAR - Farfield Warband.txt"
FEN = "countries/FEN - Fenrir.txt"
FFI = "countries/FFI - Freedom Fighters.txt"
FIE = "countries/FIE - The Fiends.txt"
FLA = "countries/FLA - Flagstaff.txt"
FOR = "countries/FOR - Foragers.txt"
FRI = "countries/FRI - Frisco City.txt"
FVR = "countries/FVR - Fort Verity.txt"
GAM = "countries/GAM - Gator Maws.txt"
GDH = "countries/GDH - Gente.txt"
GKH = "countries/GKH - Mojave Khans.txt"
GLW = "countries/GLW - Glowbugs.txt"
GRA = "countries/GRA - Grabber Territory.txt"
GRD = "countries/GRD - Guardians.txt"
GRH = "countries/GRH - Guerreros de Honduras.txt"
HAI = "countries/HAI - Haida Confederation.txt"
HAM = "countries/HAM - New Hammond.txt"
HAN = "countries/HAN - Hangdogs.txt"
HEA = "countries/HEA - Heaven's Gate.txt"
HGH = "countries/HGH - High Chapel.txt"
HRO = "countries/HRO - Houston Rockets.txt"
HUA = "countries/HUA - Hualapai.txt"
HXL = "countries/HXL - Hexie Lu.txt"
IMO = "countries/IMO - Ironmongers.txt"
INR = "countries/INR - IronRivers.txt"
IRE = "countries/IRE - Ires.txt"
IRN = "countries/IRN - IronAlliance.txt"
ITZ = "countries/ITZ - Chichen Itza.txt"
JAC = "countries/JAC - Jackles.txt"
JCT = "countries/JCT - Jacobstown.txt"
JIC = "countries/JIC - Jicarilla.txt"
KAM = "countries/KAM - Kamlo Survivalists.txt"
KHA = "countries/KHA - Great Khans.txt"
KLA = "countries/KLA - Klameth.txt"
KOT = "countries/KOT - Kingdom of Theramore.txt"
LAC = "countries/LAC - Lanius's Cohort.txt"
LAM = "countries/LAM - Lambda Tribe.txt"
LGS = "countries/LGS - Las Granjas.txt"
LNS = "countries/LNS - Lonestar.txt"
LON = "countries/LON - Lonetree.txt"
LOS = "countries/LOS - Los.txt"
LUB = "countries/LUB - Lubbock.txt"
LUL = "countries/LUL - Lunar Legion.txt"
LUM = "countries/LUM - Luminous Ones.txt"
MAX = "countries/MAX - Maximilian.txt"
MDT = "countries/MDT - Marrow Drinkers.txt"
#MZZ is used as a tag alias. Do not use it here.
MES = "countries/MES - Mescalero Nation.txt"
MLT = "countries/MLT - Mirelurk Tribe.txt"
MOC = "countries/MOC - Moctezuma.txt"
MOJ = "countries/MOJ - Mojave Chapter.txt"
MOS = "countries/MOS - Mountain Springs.txt"
MOT = "countries/MOT - Mojave Territories.txt"
MRA = "countries/MRA - Mojave Raiders.txt"
MTM = "countries/MTM - The Minutemen.txt"
MUR = "countries/MUR - Murtaugh.txt"
MXC = "countries/MXC - Maxson Chapter.txt"
MXT = "countries/MXT - Mexico Territory.txt"
NAV = "countries/NAV - Navajo Nation.txt"
NCN = "countries/NCN - New Canaanites.txt"
NEW = "countries/NEW - New Reno.txt"
NFT = "countries/NFT - Northern Frontier.txt"
NMS = "countries/NMS - New Mexico State.txt"
NOE = "countries/NOE - Noemen.txt"
NPE = "countries/NPE - North Pole Enclave.txt"
ODY = "countries/ODY - ODYSSEUS.txt"
OLY = "countries/OLY - Olympus Tribe.txt"
ORO = "countries/ORO - Ouroboros.txt"
PAL = "countries/PAL - Pale Folk.txt"
PAR = "countries/PAR - Painted Rock.txt"
PEC = "countries/PEC - Pecos Colony.txt"
PER = "countries/PER - The Pursuant.txt"
PET = "countries/PET - Petro Chico.txt"
PHA = "countries/PHA - Pharohs.txt"
PHR = "countries/PHR - Phoenix Republic.txt"
PLS = "countries/PLS - Pauluss Warband.txt"
PMR = "countries/PMR - Port Maw.txt"
PNT = "countries/PNT - Painted Men.txt"
PSH = "countries/PSH - Protectron Security Hub.txt"
RAP = "countries/RAP - The Rapids.txt"
RBD = "countries/RBD - Baudelio Ranchers.txt"
RBT = "countries/RBT - Rib Breakers.txt"
REC = "countries/REC - Red Canyon.txt"
RES = "countries/RES - The Reservation.txt"
RHO = "countries/RHO - Rusty Hooks.txt"
RIO = "countries/RIO - Rio Chapter.txt"
RIP = "countries/RIP - Riperult Territory.txt"
ROB = "countries/ROB - Robot City.txt"
ROT = "countries/ROT - Rotpurgers.txt"
RRG = "countries/RRG - Rio Grande Republic.txt"
RSR = "countries/RSR - Red Sun Republic.txt"
RUB = "countries/RUB - Ruby Valley Refuge.txt"
SCA = "countries/SCA - Scrappers.txt"
SCO = "countries/SCO - Scorpions Bite.txt"
SCR = "countries/SCR - Scorpions.txt"
SHA = "countries/SHA - Shale's Army.txt"
SHI = "countries/SHI - Shi.txt"
SHO = "countries/SHO - Shoshone Nation.txt"
SIN = "countries/SIN - Sinaloa Cartel.txt"
SKY = "countries/SKY - Sky Reavers.txt"
SLE = "countries/SLE - Sleepers.txt"
SMR = "countries/SMR - Santa Muerte.txt"
SLN = "countries/SLN - Slanter.txt"
SOR = "countries/SOR - Sorrows.txt"
SOK = "countries/SOK - Sons of Kaga.txt"
SRG = "countries/SRG - Steel Rangers.txt"
SSS = "countries/SSS - Sunset Saloon.txt"
SUF = "countries/SUF - Summers Federation.txt"
SUN = "countries/SUN - Sun Dogs.txt"
SYN = "countries/SYN - Syilx Nation.txt"
TAA = "countries/TAA - Texan Arms Association.txt"
TAR = "countries/TAR - Tar Walkers.txt"
TBH = "countries/TBH - Texan Brotherhood.txt"
TCA = "countries/TCA - The Cause.txt"
TCL = "countries/TCL - Texclave.txt"
TDT = "countries/TDT - Tierra del Tzotzil.txt"
THO = "countries/THO - Mount Thorn.txt"
TIM = "countries/TIM - Timberline.txt"
TLA = "countries/TLA - Tlaloc.txt"
TLL = "countries/TLL - The Last Lodge.txt"
TLO = "countries/TLO - Tierra.txt"
TLP = "countries/TLP - The Last Patrol.txt"
TNK = "countries/TNK - The Think Tank.txt"
TLT = "countries/TLT - Texan Luisiana Territory.txt"
TOB = "countries/TOB - The Old Bones.txt"
TOC = "countries/TOC - The Old Country.txt"
TOF = "countries/TOF - The 215.txt"
TON = "countries/TON - Tohono Nation.txt"
TPM = "countries/TPM - The Patrolmen.txt"
TRK = "countries/TRK - Turkey.txt"
TRL = "countries/TRL - Troll Warren.txt"
TSI = "countries/TSI - Ten Signs.txt"
TTM = "countries/TTM - Twin Mothers.txt"
TUB = "countries/TUB - Tubeheads.txt"
TVR = "countries/TVR - The Viceroyalty.txt"
TVT = "countries/TVT - TV Town.txt"
TWI = "countries/TWI - Twisted Hairs.txt"
TWO = "countries/TWO - Two Sun.txt"
UFO = "countries/UFO - Zetans.txt"
UIN = "countries/UIN - Uintah.txt"
UMB = "countries/UMB - Umbra.txt"
UOA = "countries/UOA - Unity of Austin.txt"
USA = "countries/USA - United States of America.txt"
UTO = "countries/UTO - State of Utobitha.txt"
VEG = "countries/VEG - Vegas.txt"
VIC = "countries/VIC - New Victoria.txt"
VIP = "countries/VIP - Vipers.txt"
VLS = "countries/VLS - Vault 27.txt"
VLT = "countries/VLT - Vault City.txt"
WAP = "countries/WAP - Western Apache.txt"
WBH = "countries/WBH - Washington Brotherhood.txt"
WEN = "countries/WEN - Wendover Republic.txt"
WHD = "countries/WHD - Withered Dogs.txt"
WHI = "countries/WHI - Whistler Nomads.txt"
WHT = "countries/WHT - White Legs.txt"
YAK = "countries/YAK - Yakama Nation.txt"
YKZ = "countries/YKZ - Yakuza Territory.txt"
YMP = "countries/YMP - Yampa Community Coalition.txt"
ZAP = "countries/ZAP - Zapata.txt"
#April Fools
KSR = "countries/KSR - Kaiser's Legion.txt"
MLP = "countries/MLP - Equestria.txt"
MIN = "countries/MIN - Hades' Horde.txt"
# NCR Temp
NCR = "countries/NCR - New California Republic.txt"
NAT = "countries/NAT - Navarro Territories.txt"
# 4.0 Tags
TDN = "countries/TDN - The Den.txt"
MXS = "countries/MXS - Max Sec.txt"
FOU = "countries/FOU - Fourways.txt"
PAC = "countries/PAC - Packers.txt"
EUR = "countries/EUR - Eureka.txt"
MOD = "countries/MOD - Modoc.txt"
# 4.x Tags
DED = "countries/DED - Deadline.txt"
OST = "countries/OST - Order of St Joseph.txt"
OQZ = "countries/OQZ - Omaha Quarantine Zone.txt"
SAN = "countries/SAN - The Sanitizers.txt"
PEN = "countries/PEN - The Penants.txt"
BRE = "countries/BRE - The Great Breach.txt"
RAD = "countries/RAD - Northern Plains Reclamation Army Depot.txt"
REH = "countries/REH - Reaver Heretics.txt"
LAP = "countries/LAP - Crow Creek.txt"
GLC = "countries/GLC - Glow's Cradle.txt"
FRN = "countries/FRN - The Fringe.txt"
TLR = "countries/TLR - The Last Redoubt.txt"
SIY = "countries/SIY - Site Y.txt"
# 5.0 Tags
ROS = "countries/ROS - Republic of the Steam.txt"
MCA = "countries/MCA - MacArthur.txt"
PAS = "countries/PAS - Passkeepers.txt"
NIT = "countries/NIT - Niitsitapi.txt"
MNC = "countries/MNC - Montana Chapter.txt"
PRO = "countries/PRO - Far Son.txt"
SIE = "countries/SIE - Sietch.txt"
TPL = "countries/TPL - Two Peoples.txt"
WYR = "countries/WYR - Wyoming Ranchers.txt"
STR = "countries/STR - Standing Rock.txt"
MRR = "countries/MRR - Marshall Republic.txt"
CPK = "countries/CPK - Coal Consortium.txt"
RMT = "countries/RMT - Rushmore Tribals.txt"
ATM = "countries/ATM - Children of the Atom.txt"
DRA = "countries/DRA - Dramatae.txt"
JCK = "countries/JCK - Jacksons.txt"
VTS = "countries/VTS - Vault Thirty Seven.txt"
BIS = "countries/BIS - Bismarck.txt"
HVR = "countries/HVR - Havre.txt"
MET = "countries/MET - Metal Mouth.txt"
BTH = "countries/BTH - Big Thinkers.txt"
RCK = "countries/RCK - Roach King.txt"
HST = "countries/HST - Historians.txt"
STM = "countries/STM - Storm Mongers.txt"
SNO = "countries/SNO - Snowmads.txt"
STC = "countries/STC - Strathcommune.txt"
MDM = "countries/MDM - Middlemark.txt"
WPG = "countries/WPG - Republic of Three Rivers.txt"
STN = "countries/STN - Governate of Stoon.txt"
NUN = "countries/NUN - Southern Expedition of Nunavut.txt"
STA = "countries/STA - The Great Stampede.txt"
BRA = "countries/BRA - Kingdom of Brandon.txt"
COM = "countries/COM - Commonwealth Remnants.txt"
IRC = "countries/IRC - Iron Confederacy.txt"
LOI = "countries/LOI - Loid's Ministry.txt"
BGR = "countries/BGR - Big Grass.txt"
NEU = "countries/NEU - Neutral Zone.txt"
ENT = "countries/ENT - Entrance.txt"
DLN = "countries/DLN - Duchy of Langenburg.txt"
YRK = "countries/YRK - County of Yorkton.txt"
MJW = "countries/MJW - State of Moose Jaw.txt"
BIG = "countries/BIG - Biggar Gang.txt"
STB = "countries/STB - Stained Backs.txt"
GIM = "countries/GIM - Forgehold of Gimli.txt"
TPA = "countries/TPA - Gateway Gang.txt"
MTC = "countries/MTC - Metis Congress.txt"
ARB = "countries/ARB - Arborg Junta.txt"
SBR = "countries/SBR - Strasbourg's Smashers.txt"
DUN = "countries/DUN - Dundurn.txt"
ELB = "countries/ELB - Elbo.txt"
FRG = "countries/FRG - Fairy Glen.txt"
PAP = "countries/PAP - Prince Albert's Privateers.txt"
ROL = "countries/ROL - Riders of Our Heavy Lady.txt"
URA = "countries/URA - Uranium City.txt"
BAT = "countries/BAT - Batford Brigade.txt"
BAD = "countries/BAD - Batford Directive.txt"
DMM = "countries/DMM - The Dammed.txt"
MTR = "countries/MTR - Mad Trains.txt"
PLT = "countries/PLT - Pleasantdale.txt"
RRR = "countries/RRR - Red Range Redoubt.txt"
UNB = "countries/UNB - Unbound.txt"
WNC = "countries/WNC - Washington Enclave.txt"
NPC = "countries/NPC - North Pole Commune.txt"
CPL = "countries/CPL - Commonwealth Popular Liberation Army.txt"
CAC = "countries/CAC - Cascadian Commonwealth.txt"
SOH = "countries/SOH - Swords of Hayman.txt"
NWC = "countries/NWC - Northwestern Commonwealth.txt"
WCO = "countries/WCO - Western Commonwealth.txt"
MCO = "countries/MCO - Midwestern Commonwealth.txt"
TXC = "countries/TXC - Texan Commonwealth.txt"
MUC = "countries/MUC - Mountain Commonwealth.txt"
FSC = "countries/FSC - Four States Commonwealth.txt"
RIC = "countries/RIC - Rio Grande Commonwealth.txt"
PNC = "countries/PNC - Plains Commonwealth.txt"
SHE = "countries/SHE - Shreveport Soviet.txt"
RID = "countries/RID - Rio Independence Milita.txt"
MIC = "countries/MIC - Mexican Revolutionary Guard.txt"
UCF = "countries/UCF - The United Cartels.txt"
EOS = "countries/EOS - Enclave Rebels.txt"
VSH = "countries/VSH - Safehaven.txt"
BYE = "countries/BYE - Byemoor Bandits.txt"
KIN = "countries/KIN - Kingsley Republic.txt"
LIV = "countries/LIV - Live Wires.txt"
NTN = "countries/NTN - Newton.txt"
ORC = "countries/ORC - The Horde.txt"
BLG = "countries/BLG - Burning Legion.txt"
